0 0 0 B B B B B B 0 0
0 B B B 0 0 0 0 B 0 0
B B T 0 C B B 0 B B 0
B T T C 0 C 0 0 P B 0
B T T 0 C 0 C 0 B B 0
B B B B B B 0 0 B 0 0
0 0 0 0 0 B B B B 0 0