0 0 B B B B B B 0
0 0 B 0 0 0 0 B 0
B B B C C C 0 B 0
B P 0 C T T 0 B 0
B 0 C T T T B B 0
B B B B 0 0 B 0 0
0 0 0 B B B B 0 0