0 0 0 B B B B B 0
B B B B 0 0 T B 0
B 0 0 0 C 0 CT B 0
B 0 C C 0 C T B 0
B B P B B T T B 0
0 B B B B B B B 0