0 B B B B B B B 0 0 0
0 B 0 0 0 0 0 B B B 0
B B C B B B 0 0 0 B 0
B 0 P 0 C 0 0 C 0 B 0
B 0 T T B 0 C 0 B B 0
B B T T B 0 0 0 B 0 0
0 B B B B B B B B 0 0