0 0 0 B B B B B B B 0
0 0 B B 0 0 B 0 P B 0
0 0 B 0 0 0 B 0 0 B 0
0 0 B C 0 C 0 C 0 B 0
0 0 B 0 C B B 0 0 B 0
B B B 0 C 0 B 0 B B 0
B T T T T T 0 0 B 0 0
B B B B B B B B B 0 0